1111111111111111111111111111111
1000001000000000000000001000001
1011101011101111111011101011101
1010000010000001000000100000101
1000111000111101011110001110001
1110100010100000000010100010111
1000101110101110111010111010001
1011100000001000001000000011101
1000101110101111111010111010001
1110100010100001000010100010111
1000111010111100011110101110001
1010000010000001000000100000101
1011101011101111111011101011101
1000000000000001000000000000001
1011111011101011101011101111101
1010001000001000001000001000101
1000100011100011100011100010001
1000100000000000000000000010001
1111111111111111111111111111111