1111111111111111111
1011000100010001101
1000010001000100001
1011011101011101101
1010000001000000101
1010110111110110101
1000000000000000001
1011010110110101101
1000010100010100001
1011010111110101101
1001010000000101001
1001010111110101001
1101000001000001011
1001011101011101001
1000010000000100001
1010110101010110101
1010000100010000101
1011110111110111101
1000000000000000001
1111111111111111111