1111111111111111111
1000000000000000001
1010110111110110101
1010000100010000101
1011010101010101101
1000010001000100001
1001111101011111001
1000010000000100001
1001010110110101001
1111000100010001111
1001010111110101001
1100010000000100011
0101011101011101010
0101010101010101010
1100000001000000011
1001010111110101001
1010010001000100101
1010111100011110101
1000010001000100001
1010000000000000101
1111111111111111111