1111111111111
1000000000001
1010111110101
1010001000101
1011101011101
1010000000101
1010110110101
1000100010001
1010111110101
1010000000101
1010111110101
1000001000001
1011101011101
1000000000001
1010101010101
1000001000001
1111111111111